20 20 20 20 20 20 20 20 20 20 20 20 20 20 20 20 20 20 20 20 20 20 20 20 20 20 20 20 20 20 20 20 20 20 20 20 20 20 20 20 20 20 20 20 20 20 20 20 20 20 
20 20 20 20 20 20 20 20 20 20 20 20 20 20 20 20 20 20 20 20 20 20 20 20 20 20 20 20 20 20 20 20 20 20 20 20 20 20 20 20 20 20 20 20 20 20 20 20 20 20 
20 20 20 20 20 20 20 20 20 20 20 20 20 20 20 20 20 20 20 20 20 20 20 20 20 20 20 20 20 20 20 20 20 20 20 20 20 20 20 20 20 20 20 20 20 20 20 20 20 20 
20 20 20 20 20 20 20 20 20 20 20 20 20 20 20 20 20 20 20 20 20 20 20 20 20 20 20 20 20 20 20 20 20 20 20 20 20 20 20 20 20 20 20 20 20 20 20 20 20 20 
20 20 20 20 20 20 20 20 20 20 20 20 20 20 20 20 20 20 20 20 20 20 20 20 20 20 20 20 20 20 20 20 20 20 20 20 20 1 1 1 1 1 1 1 20 20 20 20 20 20 
20 20 20 20 20 20 20 20 20 20 20 20 20 20 20 20 20 20 20 20 20 1 1 1 1 1 1 1 1 1 20 20 20 20 20 20 1 16 16 16 16 16 16 16 1 20 20 20 20 20 
20 20 20 20 20 20 20 20 20 20 20 20 20 20 20 20 20 20 20 20 20 1 16 16 16 16 16 16 16 1 1 1 1 1 1 1 1 16 16 16 16 16 16 16 1 20 20 20 20 20 
20 20 20 20 20 20 20 20 1 1 1 20 20 20 20 20 20 20 20 20 20 1 16 1 1 1 1 1 16 1 1 1 1 1 1 1 1 16 16 16 16 16 0 16 1 20 20 20 20 20 
20 20 20 20 20 20 20 1 16 16 16 1 1 1 1 1 1 1 1 1 1 1 16 1 16 16 16 1 16 1 20 20 20 20 20 20 1 16 16 16 16 16 16 16 1 20 20 20 20 20 
20 20 20 20 20 20 20 1 16 16 16 1 1 1 1 1 1 1 1 1 1 1 16 1 16 1 16 1 16 1 20 20 20 20 20 20 20 1 1 1 1 1 1 1 20 20 20 20 20 20 
20 20 20 20 20 20 20 1 16 16 16 1 1 1 1 1 1 1 1 1 1 1 16 1 16 16 16 1 16 1 20 20 20 20 20 20 20 20 20 20 20 20 20 20 20 20 20 20 20 20 
20 20 20 20 20 20 20 20 1 1 1 20 20 20 20 20 20 20 20 20 20 1 16 1 1 1 1 1 16 1 20 20 20 20 20 20 20 20 1 1 1 1 1 20 20 20 20 20 20 20 
20 20 20 20 20 20 20 20 20 20 20 20 20 20 20 20 20 20 20 20 20 1 16 16 16 16 16 16 16 1 20 20 20 20 20 20 20 1 1 16 16 16 16 1 20 20 20 20 20 20 
20 20 20 20 20 20 20 20 20 20 20 20 20 20 20 20 20 20 20 20 20 1 1 1 1 1 1 1 1 1 20 20 20 20 20 20 20 1 16 16 16 16 16 16 1 20 20 20 20 20 
20 20 20 20 20 20 20 20 20 20 20 20 20 20 20 20 20 20 20 20 20 20 20 20 1 1 1 20 20 20 20 20 20 20 20 20 20 1 16 16 16 16 0 16 1 20 20 20 20 20 
20 20 20 20 20 20 20 20 20 20 20 20 20 20 20 20 20 20 20 20 20 20 20 20 1 1 1 20 20 20 20 20 20 20 20 20 20 1 16 16 16 16 16 16 1 20 20 20 20 20 
20 20 20 20 20 20 20 20 20 1 1 1 1 20 20 20 20 20 20 20 20 20 20 20 1 1 1 20 20 20 20 20 20 20 20 20 20 1 16 16 16 16 16 16 1 20 20 20 20 20 
20 20 20 20 20 20 20 20 1 16 16 16 16 1 20 20 20 20 20 20 20 20 20 20 1 1 1 20 20 20 20 20 20 20 20 20 20 20 1 16 16 16 16 1 20 20 20 20 20 20 
20 20 20 20 20 20 20 1 16 16 16 16 16 16 1 20 20 20 20 20 20 20 20 20 1 1 1 20 20 20 20 20 20 20 20 20 20 20 20 1 1 1 1 20 20 20 20 20 20 20 
20 20 20 20 20 20 20 1 16 16 16 16 16 16 1 20 20 20 20 20 20 20 1 1 1 1 1 1 1 20 20 20 20 20 20 20 20 20 20 20 20 20 20 20 20 20 20 20 20 20 
20 20 20 20 20 20 20 1 16 16 16 16 16 16 1 20 20 20 20 20 20 1 16 16 16 16 16 16 16 1 20 20 20 20 20 20 20 20 20 20 20 20 20 20 20 20 20 20 20 20 
20 20 20 20 20 20 20 1 16 16 16 16 16 16 1 20 20 20 1 1 1 16 16 16 16 16 16 16 16 16 1 1 20 20 20 20 20 20 20 1 1 1 1 20 20 20 20 20 20 20 
20 20 20 20 20 20 20 1 16 16 16 16 16 16 1 1 1 1 1 16 16 16 16 16 16 16 16 16 16 16 16 1 1 1 1 1 1 1 1 1 16 16 1 20 20 20 20 20 20 20 
20 20 20 20 20 20 20 1 16 16 16 16 16 16 1 1 1 1 1 16 16 16 16 16 16 16 16 16 16 16 16 1 1 1 1 1 1 1 1 1 16 16 1 20 20 20 20 20 20 20 
20 20 20 20 20 20 20 1 16 16 16 16 16 16 1 20 20 20 1 1 1 16 16 16 16 16 16 16 16 16 1 1 20 20 20 20 20 20 20 1 1 1 1 20 20 20 20 20 20 20 
20 20 20 20 20 20 20 1 16 16 16 16 16 16 1 20 20 20 20 20 20 1 16 16 16 16 16 16 16 1 20 20 20 20 20 20 20 20 20 20 1 1 20 20 20 20 20 20 20 20 
20 20 20 20 20 20 20 1 16 16 16 16 16 16 1 20 20 20 20 20 20 20 1 1 1 1 1 1 1 20 20 20 20 20 20 20 20 20 20 20 1 1 20 20 20 20 20 20 20 20 
20 20 20 20 20 20 20 1 16 16 16 16 16 16 1 20 20 20 20 20 20 20 20 20 1 1 1 20 20 20 20 20 20 20 20 20 20 20 20 20 1 1 20 20 20 20 20 20 20 20 
20 20 20 20 20 20 20 20 1 16 16 16 16 1 20 20 20 20 20 20 20 20 20 20 1 1 1 20 20 20 20 20 20 20 20 20 20 20 20 20 1 1 20 20 20 20 20 20 20 20 
20 20 20 20 20 20 20 20 20 1 1 1 1 20 20 20 20 20 20 20 20 20 20 20 1 1 1 20 20 20 20 20 20 20 20 20 20 20 20 1 1 1 1 20 20 20 20 20 20 20 
20 20 20 20 20 20 20 20 20 20 20 20 20 20 20 20 20 20 20 20 20 20 20 20 1 1 1 20 20 20 20 20 20 20 20 20 20 20 20 1 16 16 1 20 20 20 20 20 20 20 
20 20 20 20 20 20 20 20 20 20 20 20 20 20 20 20 20 20 20 20 20 20 20 20 1 1 1 20 20 20 20 20 20 20 20 20 20 20 20 1 16 16 1 20 20 20 20 20 20 20 
20 20 20 20 20 20 20 20 20 20 20 20 20 20 20 20 20 20 20 20 20 20 20 20 1 1 1 20 20 20 20 20 1 1 1 1 1 20 20 20 1 1 20 20 20 20 20 20 20 20 
20 20 20 20 20 20 20 20 1 1 1 1 1 1 1 1 1 1 1 1 20 20 20 20 1 1 1 20 20 20 20 1 16 16 16 16 16 1 20 20 20 20 20 20 20 20 20 20 20 20 
20 20 20 20 20 20 20 20 1 16 16 16 16 16 16 16 16 16 16 1 1 1 1 1 1 1 1 1 1 1 1 1 16 16 16 16 16 1 20 20 20 20 20 20 20 20 20 20 20 20 
20 20 20 20 20 20 20 20 1 16 16 16 16 16 16 16 16 16 16 1 1 1 1 1 1 1 1 1 1 1 1 1 16 16 16 16 16 1 20 20 20 20 20 20 20 20 20 20 20 20 
20 20 20 20 20 20 20 20 1 16 16 16 16 16 16 16 16 16 16 1 1 1 1 1 1 1 1 1 1 1 1 1 16 16 16 16 16 1 20 20 20 20 20 20 20 20 20 20 20 20 
20 20 20 20 20 20 20 20 1 1 1 1 1 1 1 1 1 1 1 1 20 20 20 20 1 1 1 20 20 20 20 1 16 16 16 16 16 1 20 20 20 20 20 20 20 20 20 20 20 20 
20 20 20 20 20 20 20 20 20 20 20 20 20 20 20 20 20 20 20 20 20 20 20 20 1 1 1 20 20 20 20 20 1 1 1 1 1 20 20 20 20 20 20 20 20 20 20 20 20 20 
20 20 20 20 20 20 20 20 20 20 20 20 20 20 20 20 20 20 20 20 20 20 20 20 1 1 1 20 20 20 20 20 20 20 20 20 20 20 20 20 20 20 20 20 20 20 20 20 20 20 
20 20 20 20 20 1 16 16 3 3 1 16 1 16 1 1 1 16 1 1 16 1 1 16 1 1 1 16 16 16 1 1 1 16 16 1 1 16 16 16 16 1 20 1 1 20 20 20 20 20 
20 20 20 20 20 1 16 1 1 1 1 1 1 16 16 1 1 16 1 16 1 16 1 16 1 1 1 16 1 1 16 1 16 1 1 16 1 16 1 1 1 20 20 20 1 20 20 20 20 20 
20 20 20 20 20 1 16 16 16 16 1 16 1 16 1 16 1 16 1 16 1 16 1 16 1 1 1 16 16 16 1 1 16 1 1 16 1 16 16 16 16 1 1 1 1 20 20 20 20 20 
20 20 20 20 20 1 16 1 1 1 1 16 1 16 1 1 16 16 1 16 16 16 1 16 1 1 1 16 1 1 16 1 16 1 1 16 1 1 1 1 16 20 20 20 1 20 20 20 20 20 
20 20 20 20 20 1 16 1 1 1 1 16 1 16 1 1 1 16 1 16 1 16 1 16 16 16 1 16 16 16 1 1 1 16 16 1 1 16 16 16 16 1 20 1 1 20 20 20 20 20 
20 20 20 20 20 20 20 20 20 20 20 20 20 20 20 20 20 20 20 20 20 20 20 20 20 20 20 20 20 20 20 20 20 20 20 20 20 20 20 20 20 20 20 20 20 20 20 20 20 20 
20 20 20 20 20 20 20 20 20 20 20 20 20 20 20 20 20 20 20 20 20 20 20 20 20 20 20 20 20 20 20 20 20 20 20 20 20 20 20 20 20 20 20 20 20 20 20 20 20 20 
20 20 20 20 20 20 20 20 20 20 20 20 20 20 20 20 20 20 20 20 20 20 20 20 20 20 20 20 20 20 20 20 20 20 20 20 20 20 20 20 20 20 20 20 20 20 20 20 20 20 
20 20 20 20 20 20 20 20 20 20 20 20 20 20 20 20 20 20 20 20 20 20 20 20 20 20 20 20 20 20 20 20 20 20 20 20 20 20 20 20 20 20 20 20 20 20 20 20 20 20 
20 20 20 20 20 20 20 20 20 20 20 20 20 20 20 20 20 20 20 20 20 20 20 20 20 20 20 20 20 20 20 20 20 20 20 20 20 20 20 20 20 20 20 20 20 20 20 20 20 20 
