20 20 20 20 20 20 20 20 20 20 20 20 20 20 20 20 20 20 20 20 20 20 20 20 20 20 20 20 20 20 20 20 20 20 20 20 20 20 20 20 20 20 20 20 20 20 20 20 20 20 
20 20 20 20 20 20 20 20 20 20 20 20 20 20 20 20 20 20 20 20 20 20 20 20 20 20 20 20 20 20 20 20 20 20 20 20 20 20 20 20 20 20 20 20 20 20 20 20 20 20 
20 20 20 20 20 20 20 20 20 20 20 20 20 20 20 20 20 20 20 20 20 20 20 20 20 20 20 20 20 20 20 20 20 20 20 20 20 20 20 20 20 20 20 20 20 20 20 20 20 20 
20 20 20 20 20 20 20 20 20 20 20 20 20 20 20 20 20 20 20 20 20 20 20 20 20 20 20 20 20 20 20 20 20 20 20 20 20 20 20 20 20 20 20 20 20 20 20 20 20 20 
20 20 20 20 20 20 20 20 20 20 20 20 20 20 20 20 20 20 20 20 20 20 20 20 20 20 20 20 20 20 20 20 20 20 20 20 20 20 20 20 20 20 20 20 20 20 20 20 20 20 
20 20 20 20 20 20 20 20 20 20 20 20 20 20 20 20 20 20 20 20 20 20 20 20 20 20 20 20 20 20 20 20 20 20 20 20 20 20 20 20 20 20 20 20 20 20 20 20 20 20 
20 20 20 20 20 20 20 20 20 20 20 20 20 20 20 20 20 20 20 20 20 20 20 20 20 20 20 20 20 20 20 20 20 20 20 20 20 20 20 20 20 20 20 20 20 20 20 20 20 20 
20 20 20 20 20 20 20 20 20 20 20 20 20 20 20 20 20 20 20 20 20 20 20 20 20 20 20 20 20 20 20 20 20 20 20 20 20 20 20 20 20 20 20 20 20 20 20 20 20 20 
20 20 20 20 20 20 20 20 20 16 16 16 16 16 16 16 16 16 16 16 16 16 16 16 20 20 20 20 20 20 20 20 20 20 20 20 20 20 20 16 20 20 20 20 20 20 20 20 20 20 
20 20 20 20 20 20 20 16 16 16 16 16 16 16 16 16 16 16 16 16 16 16 16 16 16 16 20 20 20 20 20 20 20 20 20 20 20 20 16 16 16 20 20 20 20 20 20 20 20 20 
20 20 20 20 20 20 20 16 16 16 16 16 16 16 16 16 16 16 16 16 16 16 16 16 16 16 20 20 20 20 20 20 20 20 20 20 20 16 16 16 16 16 20 20 20 20 20 20 20 20 
20 20 20 20 20 20 20 16 16 16 16 16 16 16 16 16 16 16 16 16 16 16 16 16 16 16 20 20 20 20 20 20 20 20 20 20 16 16 16 16 16 16 16 20 20 20 20 20 20 20 
20 20 20 20 20 20 20 16 16 16 16 16 16 16 16 16 16 16 16 16 16 16 16 16 16 16 20 20 20 20 20 20 20 20 20 16 16 16 16 16 16 16 16 16 20 20 20 20 20 20 
20 20 20 20 20 20 20 16 16 16 16 16 16 16 16 16 16 16 16 16 16 16 16 16 16 16 1 1 1 1 1 1 1 1 1 16 16 16 16 16 16 16 16 16 16 20 20 20 20 20 
20 20 20 20 20 20 20 16 3 16 16 16 16 16 16 16 16 16 16 16 16 16 16 16 16 16 1 1 1 1 1 1 1 1 1 16 16 16 16 16 16 16 16 16 16 16 20 20 20 20 
20 20 20 20 20 20 20 16 16 16 16 16 16 16 16 16 16 16 16 16 16 16 16 16 16 16 1 1 1 1 1 1 1 1 1 16 16 16 16 16 16 16 16 16 16 20 20 20 20 20 
20 20 20 20 20 20 20 16 16 16 16 16 16 16 16 16 16 16 16 16 16 16 16 16 16 16 20 20 20 20 20 20 20 20 20 16 16 16 16 16 16 16 16 16 20 20 20 20 20 20 
20 20 20 20 20 20 20 16 16 16 16 16 16 16 16 16 16 16 16 16 16 16 16 16 16 16 20 20 20 20 20 20 20 20 20 20 16 16 16 16 16 16 16 20 20 20 20 20 20 20 
20 20 20 20 20 20 20 16 16 16 16 16 16 16 16 16 16 16 16 16 16 16 16 16 16 16 20 20 20 20 20 20 20 20 20 20 20 16 16 16 16 16 20 20 20 20 20 20 20 20 
20 20 20 20 20 20 20 16 16 16 16 16 16 16 16 16 16 16 16 16 16 16 16 16 16 16 20 20 20 20 20 20 20 20 20 20 20 20 1 1 1 20 20 20 20 20 20 20 20 20 
20 20 20 20 20 20 20 20 20 16 16 16 16 16 16 16 16 16 16 16 16 16 16 16 20 20 20 16 16 16 16 16 20 20 20 20 20 20 1 1 1 20 20 20 20 20 20 20 20 20 
20 20 20 20 20 20 20 20 20 20 20 20 20 20 20 20 20 20 20 20 20 20 20 20 20 20 20 16 16 16 16 16 20 20 20 20 20 20 1 1 1 20 20 20 20 20 20 20 20 20 
20 20 20 20 20 20 20 20 20 20 20 20 20 20 20 20 20 20 16 16 16 16 20 20 20 20 20 16 16 16 16 16 1 1 1 1 1 1 1 1 1 20 20 20 20 20 20 20 20 20 
20 20 20 20 20 20 20 20 20 20 20 20 20 20 20 20 20 16 16 16 16 16 16 20 20 20 20 16 16 16 16 16 1 1 1 1 1 1 1 1 1 20 20 20 20 20 20 20 20 20 
20 20 20 20 20 20 20 20 20 20 20 20 20 20 20 20 20 16 16 16 16 16 16 20 20 20 20 16 16 16 16 16 1 1 1 1 1 1 1 1 1 20 20 20 20 20 20 20 20 20 
20 20 20 20 20 20 20 20 20 20 20 20 20 20 20 20 20 16 16 16 16 16 16 20 20 20 20 16 16 3 16 16 20 20 20 20 20 20 1 1 1 20 20 20 20 20 20 20 20 20 
20 20 20 20 20 20 20 20 20 20 20 20 20 20 20 20 20 20 20 1 1 20 20 20 20 20 20 16 16 16 16 16 20 20 20 20 20 20 1 1 1 20 20 20 20 20 20 20 20 20 
20 20 20 20 20 20 20 20 20 20 20 20 20 20 20 20 20 20 20 1 1 20 20 20 20 20 20 20 20 20 20 20 20 20 20 20 20 20 1 1 1 20 20 20 20 20 20 20 20 20 
20 20 20 20 20 20 20 20 20 20 20 20 20 20 20 20 20 20 16 16 16 16 20 20 20 20 20 20 20 20 20 20 20 20 20 20 20 16 16 16 16 16 20 20 20 20 20 20 20 20 
20 20 20 20 20 20 20 16 16 16 16 16 20 20 20 20 20 16 16 16 16 16 16 20 20 20 20 1 1 1 1 1 20 20 20 20 16 16 16 16 16 16 16 20 20 20 20 20 20 20 
20 20 20 20 20 20 20 16 16 16 16 16 20 20 20 20 16 16 16 16 16 16 16 1 1 1 1 1 1 1 1 1 1 1 1 1 16 16 16 16 16 16 16 20 20 20 20 20 20 20 
20 20 20 20 20 20 16 16 16 16 16 16 1 1 1 1 16 16 16 16 16 16 16 1 1 1 1 1 1 1 1 1 1 1 1 1 16 16 16 16 16 16 16 20 20 20 20 20 20 20 
20 20 20 20 20 20 16 16 16 3 16 16 20 20 20 20 16 16 16 16 16 16 16 1 1 1 1 1 1 1 1 1 1 1 1 1 16 16 16 16 16 16 16 20 20 20 20 20 20 20 
20 20 20 20 20 20 20 16 16 16 16 16 20 20 20 20 20 16 16 16 16 16 16 20 20 20 20 1 1 1 1 1 20 20 20 20 16 16 16 16 16 16 16 20 20 20 20 20 20 20 
20 20 20 20 20 20 20 16 16 16 16 16 20 20 20 20 20 20 1 1 1 1 20 20 20 20 20 20 20 1 20 20 20 20 20 20 20 16 16 16 16 16 20 20 20 20 20 20 20 20 
20 20 20 20 20 20 20 20 20 20 20 20 20 20 20 20 20 20 1 1 1 1 20 20 20 20 20 20 20 1 20 20 20 20 20 20 20 20 1 1 1 20 20 20 20 20 20 20 20 20 
20 20 20 20 20 20 20 20 20 20 20 20 20 20 20 20 20 20 1 1 1 1 20 20 20 20 16 16 16 16 16 16 16 20 20 20 20 20 1 1 1 20 20 20 20 20 20 20 20 20 
20 20 20 20 20 20 20 20 20 20 20 20 20 20 20 20 20 20 1 1 1 1 20 20 20 20 16 16 16 16 16 16 16 20 20 20 20 20 1 1 1 20 20 20 20 20 20 20 20 20 
20 20 20 20 20 20 20 20 20 20 20 20 20 20 20 20 20 20 1 1 1 1 20 20 20 20 16 16 16 16 16 16 16 20 20 20 20 20 1 1 1 20 20 20 20 20 20 20 20 20 
20 20 20 20 20 20 16 16 16 20 20 20 20 20 20 20 20 20 1 1 1 1 20 20 20 20 16 16 16 16 16 16 16 20 20 20 20 20 1 1 1 20 20 20 20 20 20 20 20 20 
20 20 20 20 20 16 16 16 16 1 1 1 1 1 1 1 1 1 1 1 1 1 20 20 20 20 16 16 16 16 16 16 16 20 20 16 16 16 16 16 16 16 16 16 20 20 20 20 20 20 
20 20 20 20 20 16 16 3 16 1 1 1 1 1 1 1 1 1 1 1 1 1 20 20 20 20 20 20 20 20 20 20 20 20 20 16 18 16 16 18 16 16 18 16 20 20 20 20 20 20 
20 20 20 20 20 16 16 16 16 1 1 1 1 1 1 1 1 1 1 1 1 1 20 20 20 20 20 20 20 20 20 20 20 20 20 16 16 16 16 16 16 16 16 16 20 20 20 20 20 20 
20 20 20 20 20 20 16 16 16 20 20 20 20 20 20 20 20 20 20 20 20 20 20 20 20 20 20 20 20 20 20 20 20 20 20 16 18 16 16 18 16 16 18 16 20 20 20 20 20 20 
20 20 20 20 20 20 20 20 20 20 20 20 20 20 20 20 20 20 20 20 20 20 20 20 20 20 20 20 20 20 20 20 20 20 20 16 16 16 16 16 16 16 16 16 20 20 20 20 20 20 
20 20 20 20 20 20 20 20 20 20 20 20 20 20 20 20 20 20 20 20 20 20 20 20 20 20 20 20 20 20 20 20 20 20 20 20 20 20 20 20 20 20 20 20 20 20 20 20 20 20 
20 20 20 20 20 20 20 20 20 20 20 20 20 20 20 20 20 20 20 20 20 20 20 20 20 20 20 20 20 20 20 20 20 20 20 20 20 20 20 20 20 20 20 20 20 20 20 20 20 20 
20 20 20 20 20 20 20 20 20 20 20 20 20 20 20 20 20 20 20 20 20 20 20 20 20 20 20 20 20 20 20 20 20 20 20 20 20 20 20 20 20 20 20 20 20 20 20 20 20 20 
20 20 20 20 20 20 20 20 20 20 20 20 20 20 20 20 20 20 20 20 20 20 20 20 20 20 20 20 20 20 20 20 20 20 20 20 20 20 20 20 20 20 20 20 20 20 20 20 20 20 
20 20 20 20 20 20 20 20 20 20 20 20 20 20 20 20 20 20 20 20 20 20 20 20 20 20 20 20 20 20 20 20 20 20 20 20 20 20 20 20 20 20 20 20 20 20 20 20 20 20 
