22 21 21 21 22 21 21 21 22 21 21 22 21 21 21 21 21 21 21 21 22 21 21 21 21 21 21 21 21 21 21 21 21 22 21 21 21 22 21 21 22 21 22 21 21 21 21 22 21 21 
21 21 22 21 21 22 21 21 21 21 21 21 21 22 21 21 22 22 21 21 21 22 21 21 21 21 21 22 21 22 21 21 21 21 21 21 21 21 21 21 21 21 21 21 21 22 21 21 22 21 
21 21 21 21 21 21 22 21 22 21 21 22 21 21 21 21 21 21 21 22 21 21 21 22 21 21 22 21 21 21 21 21 22 21 21 22 21 21 21 22 21 21 22 21 21 21 21 21 21 21 
21 21 22 22 21 22 21 21 22 21 21 21 21 21 21 21 21 21 21 21 21 21 21 21 22 21 21 21 21 21 22 21 21 21 21 21 21 21 21 21 21 21 21 21 21 22 21 21 22 21 
21 21 21 21 21 21 21 21 22 21 21 22 21 21 22 21 21 21 21 21 21 21 21 22 22 21 21 21 21 22 21 21 21 21 21 21 21 22 21 21 22 21 22 21 21 21 21 21 21 21 
22 21 21 22 22 21 21 22 21 21 21 21 22 21 21 21 22 21 21 21 22 21 21 21 21 21 21 22 21 21 21 31 29 29 32 21 21 21 21 21 21 21 21 21 22 21 22 21 21 21 
21 22 21 22 21 21 21 22 21 21 21 21 21 22 21 21 21 21 21 22 21 21 22 21 22 21 21 21 21 22 31 30 19 19 28 29 29 29 29 29 29 29 32 21 21 21 21 21 21 21 
21 21 21 21 21 22 21 21 21 22 21 21 21 21 21 21 31 29 29 29 29 29 29 29 29 29 29 29 32 22 27 19 19 19 19 19 19 19 19 19 19 19 28 32 22 21 21 22 21 21 
21 22 21 22 21 21 22 22 21 21 21 31 29 29 29 29 30 19 19 19 19 19 12 10 10 10 13 19 28 29 30 19 19 19 19 19 19 19 19 19 19 19 19 26 21 21 21 21 21 21 
21 21 21 22 21 21 21 21 21 21 31 30 19 19 19 19 19 19 19 19 19 17 11 3 3 3 7 19 19 19 19 19 19 19 19 12 10 10 10 13 19 19 19 26 21 22 21 21 22 21 
22 21 21 22 22 21 21 22 31 29 30 19 19 19 19 19 19 19 12 10 10 11 3 3 3 3 7 19 19 19 19 19 19 19 19 8 16 16 16 7 19 19 19 28 32 21 21 21 21 21 
21 21 21 21 21 21 21 31 30 19 19 19 19 19 19 19 19 19 8 3 3 3 16 16 3 3 7 19 19 19 19 19 19 19 19 8 16 16 16 7 19 19 19 19 26 21 21 21 21 21 
21 21 22 21 21 21 31 30 19 19 19 19 19 12 10 10 13 19 8 3 4 5 5 5 5 5 15 19 19 19 19 19 19 19 19 8 16 16 16 7 19 19 19 19 26 21 22 21 22 21 
21 21 21 21 22 31 30 19 19 19 19 19 19 8 3 3 7 19 8 3 7 19 19 19 19 19 19 12 10 10 13 19 19 19 19 14 6 3 4 15 19 19 19 19 26 21 21 22 21 21 
21 21 21 21 21 27 19 19 19 19 12 10 10 11 3 3 7 19 8 3 7 19 12 10 10 10 10 11 3 3 9 13 19 19 19 19 8 3 7 19 19 19 19 19 26 21 22 21 22 21 
21 22 21 22 21 27 19 19 19 12 11 3 3 3 3 3 9 10 11 3 9 10 11 3 3 3 3 3 3 3 3 9 13 19 19 19 8 3 7 19 19 19 19 19 26 21 21 21 22 21 
21 21 21 21 21 27 19 19 19 8 3 3 3 3 3 3 3 3 3 3 3 3 3 3 3 3 3 3 3 3 3 3 7 17 19 19 8 3 7 19 19 19 19 23 34 21 22 21 22 21 
21 21 21 21 22 27 19 19 19 8 3 3 3 3 3 3 16 16 4 5 5 5 6 3 3 3 3 3 3 3 3 3 7 17 19 19 8 3 7 19 19 19 19 26 21 21 21 21 21 21 
21 22 22 21 21 33 25 19 19 8 3 3 3 3 3 3 4 5 15 19 19 19 14 6 16 16 3 3 3 3 3 3 7 19 19 19 8 3 7 19 19 19 19 26 22 21 22 21 21 22 
21 21 21 21 21 21 27 19 19 14 6 3 3 3 3 4 15 19 19 19 19 19 19 14 5 6 3 3 3 3 3 4 15 19 19 19 8 3 7 19 19 19 19 26 21 21 21 21 21 21 
22 21 21 21 22 21 27 19 19 19 14 6 3 3 3 7 19 19 12 10 10 13 19 19 19 8 3 3 4 5 5 15 19 19 19 19 8 3 7 19 19 19 19 28 32 22 22 22 21 21 
21 21 22 21 21 21 27 19 19 19 19 14 6 3 4 15 19 12 11 3 3 9 10 13 19 8 16 3 7 19 19 19 12 10 10 13 8 3 7 19 19 19 19 19 26 21 21 21 21 22 
21 21 21 22 21 22 33 25 19 19 19 19 8 3 7 19 19 8 3 3 3 3 3 7 19 8 3 3 7 19 19 19 8 3 3 7 8 3 7 12 10 13 19 19 26 21 21 22 22 22 
21 21 21 21 21 21 21 27 19 19 19 19 8 3 9 13 12 11 3 3 3 3 3 7 19 8 3 4 15 19 19 19 8 3 3 9 11 3 9 11 3 9 13 19 26 21 21 21 21 21 
22 21 22 21 21 21 21 33 25 19 19 19 8 3 3 7 8 3 3 3 3 3 4 15 19 8 3 7 19 19 19 19 14 6 3 3 3 3 3 3 3 3 7 19 26 21 22 22 21 21 
21 21 21 21 21 22 21 21 27 19 19 19 14 6 3 9 11 3 3 3 3 4 15 19 19 8 3 9 10 10 10 10 10 11 3 3 3 3 3 3 3 3 7 19 26 21 21 21 21 22 
21 21 21 21 21 21 22 21 27 19 19 19 19 8 3 3 3 3 4 5 5 15 19 19 19 8 3 3 3 3 3 3 3 3 3 3 3 3 3 3 3 4 15 19 26 21 21 22 21 21 
21 21 21 22 21 21 22 21 33 25 19 19 19 8 3 4 5 5 15 19 19 19 19 19 19 8 3 4 5 5 5 5 5 6 3 3 3 3 3 3 3 7 19 19 26 22 21 21 21 22 
21 22 21 22 21 21 21 21 21 27 19 19 19 8 3 7 19 19 19 19 19 19 12 10 10 11 3 9 13 19 19 19 12 11 3 3 3 3 3 3 3 7 19 23 34 21 22 21 21 21 
22 21 21 21 21 22 22 21 31 30 19 19 19 8 3 9 10 10 10 10 10 10 11 3 3 3 3 3 9 13 19 19 8 3 3 4 6 3 4 6 3 7 19 26 21 21 21 21 22 22 
21 21 22 21 21 21 21 21 27 19 19 19 19 8 16 16 16 16 16 16 16 3 3 3 3 3 3 3 3 9 13 19 14 5 5 15 8 3 7 14 5 15 19 26 21 22 21 21 21 21 
21 21 21 22 21 21 21 21 27 19 19 19 19 14 5 5 5 5 5 5 6 3 3 3 3 3 3 3 3 3 7 19 19 19 19 19 8 3 7 19 19 19 19 26 21 21 22 21 21 21 
21 22 21 21 22 22 22 31 30 19 19 19 19 19 19 19 19 19 19 19 8 3 3 3 16 3 3 3 3 4 15 19 19 19 19 19 8 3 7 19 19 19 19 26 22 21 21 22 21 22 
21 21 21 22 21 21 21 27 19 12 10 10 10 10 10 10 10 13 19 19 14 5 5 6 16 3 4 5 5 15 19 19 19 19 19 19 8 3 7 19 19 19 19 26 21 22 21 21 21 21 
21 21 22 21 21 21 31 30 19 8 3 3 3 3 3 3 3 7 19 19 19 19 12 11 3 3 7 19 19 19 19 19 19 19 19 19 8 3 7 19 19 19 19 26 21 21 21 22 22 21 
21 21 21 21 22 21 27 19 19 8 3 3 3 3 3 3 3 7 19 19 12 10 11 3 3 16 9 13 19 12 10 10 10 10 10 13 8 3 7 19 19 19 19 26 22 22 21 21 21 21 
21 21 22 21 21 21 27 19 19 19 3 3 3 3 3 3 3 9 19 10 11 3 3 3 3 3 3 7 19 8 3 3 3 3 3 9 11 3 9 10 13 19 19 28 32 21 21 21 21 22 
21 21 21 21 21 21 27 19 19 8 3 3 3 3 3 3 3 3 3 3 3 3 4 5 5 6 3 7 19 14 6 3 3 3 3 3 3 3 3 3 7 19 19 19 26 21 21 22 21 21 
21 22 21 21 21 21 27 19 19 19 3 3 3 3 3 3 4 5 19 5 5 5 15 19 19 8 3 9 13 19 8 3 3 3 3 3 3 3 3 3 7 19 19 19 26 21 21 21 21 21 
21 21 21 21 21 21 27 19 19 8 3 3 3 3 3 4 15 19 19 19 19 19 19 19 19 8 3 3 7 19 8 3 4 5 6 3 3 3 3 3 7 19 19 23 34 22 21 21 22 21 
21 21 21 22 22 21 33 25 19 14 5 5 5 5 5 15 19 19 23 24 24 24 24 25 19 14 5 5 15 19 14 5 15 19 8 3 3 3 3 4 15 19 23 34 21 21 21 21 21 21 
21 22 21 21 21 21 31 30 19 19 19 19 19 19 19 19 19 19 26 21 21 21 21 33 25 19 19 19 19 19 19 19 19 19 14 5 5 5 5 15 19 19 26 21 22 22 21 22 21 21 
21 21 21 21 21 22 27 19 19 19 23 24 25 19 19 19 19 23 34 22 21 21 22 21 33 24 24 25 19 19 19 19 19 19 19 19 19 19 19 19 19 19 26 21 21 21 21 21 21 21 
21 21 22 22 22 21 27 19 19 23 34 22 27 19 19 19 23 34 21 21 22 21 21 21 22 21 21 33 24 25 19 19 19 19 19 19 19 19 19 19 23 24 34 22 21 22 21 21 21 21 
21 22 21 21 21 21 33 24 24 34 21 21 33 24 24 24 34 21 22 21 21 22 21 21 21 21 21 21 21 33 24 24 25 19 19 19 23 24 24 24 34 21 21 21 21 21 21 21 22 21 
21 21 21 21 22 21 21 21 21 21 21 21 22 21 21 21 21 21 21 21 21 21 21 21 21 22 21 22 22 21 21 21 33 24 24 24 34 21 21 21 22 21 22 22 21 22 21 21 21 21 
21 21 22 21 21 21 21 22 21 21 22 21 21 21 21 21 21 22 21 22 21 22 21 22 21 21 21 21 21 21 21 22 21 21 21 21 21 21 22 21 21 21 21 21 22 21 22 21 21 21 
21 21 22 22 21 22 21 21 21 22 21 21 22 21 21 21 21 21 21 21 22 21 21 21 22 21 22 21 21 22 22 21 21 21 21 22 22 21 21 21 22 21 22 22 21 21 21 21 22 21 
21 22 21 21 21 21 21 22 21 21 21 21 21 21 21 21 22 21 21 21 22 22 21 21 22 21 22 21 21 21 21 21 22 22 22 21 21 22 21 22 22 22 21 21 21 22 21 21 21 21 
22 21 21 21 21 21 21 21 21 22 21 21 22 21 21 21 21 21 21 21 21 21 21 21 22 22 21 21 22 21 22 21 21 21 21 21 21 21 21 21 21 21 21 21 21 21 21 21 22 21 
