21 21 22 21 22 21 22 21 21 21 21 21 21 21 21 21 21 21 22 21 21 22 21 21 21 21 22 21 21 22 21 21 21 21 21 21 21 21 21 21 21 21 21 21 21 21 22 21 21 21 
21 21 21 21 21 21 21 21 22 21 21 21 22 21 21 22 21 21 21 21 21 21 21 21 21 21 21 21 21 21 21 21 21 22 21 21 21 21 22 22 21 22 22 22 22 21 21 21 21 22 
21 22 21 21 21 21 21 21 21 21 21 21 21 21 21 21 21 21 21 21 22 22 22 21 21 21 21 21 21 21 21 22 22 22 22 21 21 21 22 21 21 22 21 21 21 21 21 22 21 21 
21 21 21 22 22 22 21 22 21 21 21 22 21 21 21 21 22 21 22 22 22 21 21 21 21 21 22 21 21 22 22 21 21 22 21 21 21 21 21 21 21 22 21 21 21 21 21 22 21 21 
21 21 21 21 21 21 21 21 21 21 21 21 21 21 21 21 21 21 22 21 21 22 22 21 22 21 21 21 21 21 21 21 21 21 21 21 21 21 21 21 21 21 21 21 22 21 21 22 21 21 
22 21 22 21 21 21 21 21 21 22 21 21 22 22 21 21 21 21 22 21 21 21 21 21 21 21 21 22 21 21 21 21 21 21 21 21 22 21 22 21 21 21 22 21 21 21 21 22 21 21 
22 21 21 21 21 21 22 21 21 21 21 21 21 22 22 21 21 22 21 22 21 21 21 21 21 22 21 21 21 22 21 21 21 21 21 21 21 21 22 21 21 21 22 21 21 22 21 22 21 22 
21 21 21 21 22 21 22 21 21 21 21 21 21 21 21 21 21 21 21 21 21 21 21 22 21 21 21 21 21 21 21 21 22 21 22 21 21 21 21 21 21 22 21 21 21 21 21 21 21 21 
21 21 22 21 21 22 21 21 21 21 22 21 21 21 21 21 22 31 29 29 29 32 21 21 21 22 22 21 21 21 21 21 21 22 21 21 21 22 21 21 21 21 21 21 22 21 21 21 21 21 
21 21 21 21 21 21 22 21 21 31 29 29 29 29 29 29 29 30 17 17 17 26 21 21 21 21 21 21 21 21 21 31 29 29 29 32 21 21 21 31 29 29 32 21 21 21 21 22 21 21 
22 21 21 21 21 21 21 21 31 30 19 19 19 19 19 17 17 17 17 19 17 28 32 22 21 21 21 21 22 21 31 30 19 17 19 28 29 29 29 30 19 17 28 29 32 21 21 21 21 21 
21 21 21 21 21 22 21 21 27 19 12 10 10 10 10 10 10 10 13 19 19 19 26 31 29 32 21 21 21 21 27 19 19 17 17 17 19 19 17 17 19 17 19 19 26 21 21 21 22 21 
21 22 21 22 21 21 21 31 30 19 8 16 16 16 16 16 16 16 9 10 13 19 28 30 17 28 32 21 21 21 27 19 19 19 12 10 10 10 10 10 10 13 19 19 26 21 21 21 22 21 
21 21 21 22 22 21 21 27 19 17 8 16 16 16 16 16 16 16 16 16 9 10 10 10 10 13 28 32 21 21 27 19 17 17 8 4 5 5 5 5 6 7 19 19 26 21 21 21 21 21 
21 22 21 21 21 21 31 30 12 10 11 16 16 16 16 16 4 5 6 16 16 16 3 16 16 7 19 28 32 21 33 25 19 17 8 7 23 24 24 25 8 7 17 19 26 21 21 22 22 21 
21 21 21 21 21 21 27 19 8 16 16 16 16 16 16 4 15 19 14 5 6 16 16 16 4 15 17 17 26 21 21 33 25 19 8 7 28 29 29 30 8 7 19 23 34 21 22 21 21 21 
22 21 21 22 21 21 27 19 8 16 16 16 16 4 5 15 19 19 17 19 14 6 16 4 15 19 19 19 26 22 21 21 33 25 8 9 10 10 10 10 11 7 19 26 21 21 22 21 21 21 
21 22 21 21 21 31 30 19 8 16 16 16 16 7 19 19 19 19 19 12 10 11 16 7 19 17 17 17 26 21 21 22 21 27 14 5 5 5 5 5 5 15 23 34 21 21 21 21 22 21 
21 21 22 21 21 27 19 17 8 16 16 16 4 15 19 19 17 19 19 8 16 16 16 7 17 17 17 23 34 31 29 32 21 33 25 19 19 17 17 19 19 23 34 21 21 21 21 21 21 21 
21 21 21 21 21 27 19 17 14 5 5 5 15 19 17 17 17 17 17 8 16 4 5 15 17 17 17 26 31 30 17 26 21 21 27 19 17 17 17 19 23 34 21 21 21 22 21 21 21 21 
22 21 21 21 21 27 19 19 17 17 17 17 19 17 17 23 25 17 17 8 16 7 23 25 17 23 24 34 27 19 17 26 21 31 30 17 17 17 17 19 26 21 21 21 22 21 21 22 21 21 
21 21 21 22 21 33 25 19 19 19 23 24 24 24 24 34 33 24 25 14 5 15 26 33 24 34 21 21 33 24 24 34 31 30 17 17 17 19 19 19 26 22 21 21 21 21 21 21 21 21 
21 21 21 21 21 21 33 24 24 24 34 21 31 29 32 21 21 21 33 25 17 17 26 21 21 22 22 21 21 21 21 31 30 17 17 17 23 24 24 24 34 21 21 21 22 21 21 21 21 21 
21 22 22 21 21 21 21 21 21 21 21 22 27 19 28 32 22 21 21 27 17 17 28 29 32 21 21 22 22 21 31 30 17 17 17 23 34 21 21 21 21 22 21 21 21 22 21 21 21 21 
21 21 21 21 22 21 21 21 21 22 21 21 27 19 19 28 32 21 21 27 17 17 17 17 28 29 29 29 29 29 30 17 17 17 19 26 21 22 21 29 29 21 21 21 21 21 21 21 21 21 
21 21 21 21 21 22 21 21 21 21 21 21 33 25 19 19 26 22 21 33 25 17 17 17 17 17 19 19 19 17 17 17 17 23 24 34 21 31 30 17 19 28 32 21 21 21 21 22 22 21 
21 21 22 21 21 21 21 21 22 21 21 21 21 33 24 24 34 21 22 21 33 24 25 17 17 17 17 17 17 17 17 19 23 34 21 21 21 27 19 17 19 19 26 21 21 22 21 21 21 21 
21 21 21 21 21 22 21 21 21 21 21 22 31 29 29 32 21 21 21 21 22 21 27 19 17 17 17 17 17 17 17 19 26 22 21 21 22 27 19 17 17 17 26 21 21 21 21 21 22 21 
21 22 21 21 21 21 31 29 29 29 29 29 30 19 19 26 21 22 22 21 21 31 30 17 17 17 17 17 17 17 17 19 26 21 22 21 21 21 25 17 19 23 34 21 22 21 21 22 22 21 
21 21 21 21 31 29 30 19 19 19 12 10 10 10 13 28 32 21 21 21 31 30 17 17 17 19 19 19 17 17 17 17 26 21 21 22 22 21 33 24 24 34 21 21 21 21 22 21 21 21 
21 21 21 21 27 19 12 10 10 13 8 3 3 3 7 19 28 29 29 29 30 17 17 17 23 24 24 24 25 19 17 17 28 29 29 29 29 29 29 29 32 21 22 21 22 21 21 21 21 21 
22 22 21 21 27 19 8 3 3 7 14 5 5 5 15 17 12 10 10 13 17 17 17 19 26 22 21 21 33 25 17 17 19 17 17 19 17 17 17 19 28 29 32 22 21 21 21 21 21 22 
21 21 21 21 27 19 8 3 3 7 12 10 10 10 13 19 8 3 3 7 17 17 23 24 34 21 22 21 21 27 17 17 17 17 17 19 19 17 17 19 17 19 28 32 21 22 21 21 21 21 
21 21 22 21 33 25 14 5 5 15 8 3 3 3 7 17 8 3 3 7 17 23 34 21 22 21 21 31 29 30 19 12 10 10 10 13 17 12 10 10 10 13 19 28 29 32 21 22 21 21 
21 21 21 21 21 33 25 19 19 17 8 3 3 3 7 17 14 5 5 15 19 26 21 22 21 21 31 30 19 19 17 8 16 16 16 7 19 8 16 16 16 9 10 13 19 26 21 22 21 21 
21 21 21 22 21 21 33 24 25 19 8 3 3 3 7 17 12 10 10 10 13 28 32 21 21 31 30 19 19 17 17 8 16 16 16 7 17 8 16 16 16 16 16 7 17 26 21 21 21 22 
21 21 21 21 21 21 21 21 33 25 14 5 5 5 15 19 8 3 3 3 7 19 26 21 22 27 12 10 10 10 13 14 5 5 5 15 17 8 16 16 16 16 16 7 17 26 21 21 21 21 
22 21 21 22 21 22 21 21 21 33 25 19 19 19 19 19 8 3 3 3 7 19 26 22 21 27 8 16 16 16 9 13 19 17 17 17 17 14 6 16 16 16 4 15 19 26 21 21 22 21 
21 21 21 21 21 21 31 29 29 32 33 24 24 25 19 17 14 5 5 5 15 23 34 21 21 27 14 6 16 16 16 7 19 17 17 19 19 19 14 5 5 5 15 19 19 26 22 21 21 21 
21 21 21 21 21 31 30 17 19 26 21 21 21 33 24 24 25 19 19 19 23 34 21 21 21 27 19 14 5 5 5 15 19 19 19 19 17 17 17 17 17 17 17 17 17 26 21 21 21 21 
22 21 21 21 21 27 19 17 17 26 21 22 21 21 21 21 33 24 24 24 34 21 21 22 21 33 24 24 25 19 19 23 24 24 24 24 25 19 17 19 19 17 19 19 19 26 21 21 21 21 
22 21 22 21 21 33 25 19 19 26 21 21 21 21 21 22 21 21 21 21 21 22 21 21 21 21 21 21 33 24 24 34 21 22 21 21 33 24 24 24 24 24 24 24 24 34 21 21 22 21 
21 21 21 21 21 21 33 24 24 34 21 21 22 21 21 21 21 21 21 21 21 21 21 21 21 22 21 21 21 21 22 21 21 21 21 21 21 21 21 21 21 21 21 21 21 21 21 21 21 21 
21 21 21 21 21 21 21 21 21 21 21 21 21 21 21 21 21 21 22 21 21 21 22 22 21 21 22 21 22 21 21 21 21 21 21 21 22 21 21 21 21 21 21 21 22 21 22 21 21 21 
22 21 21 21 21 21 21 21 22 21 21 21 21 21 21 22 21 21 22 21 21 21 22 21 21 21 21 21 21 21 21 21 21 22 22 21 21 21 21 22 21 22 21 21 21 21 21 21 21 21 
21 22 21 21 21 22 21 21 21 21 21 21 21 21 22 21 21 21 21 21 21 21 22 21 22 22 21 21 21 22 22 21 22 22 21 21 21 21 21 21 21 22 21 21 22 21 21 21 22 21 
21 21 21 21 21 21 21 21 21 21 21 22 21 21 21 21 21 22 21 21 21 21 21 21 22 22 21 21 21 22 22 21 21 21 21 21 21 21 21 21 21 22 21 21 21 21 21 21 21 21 
21 21 21 22 21 21 21 21 22 21 21 21 21 22 21 21 21 21 21 22 21 21 21 21 22 21 21 21 22 22 21 21 21 21 21 22 22 22 21 21 21 21 21 21 21 21 21 21 22 21 
22 21 21 21 21 21 21 21 21 21 21 22 21 21 21 22 21 21 21 21 21 21 21 21 21 21 22 22 22 21 21 21 21 21 21 21 21 21 21 21 21 22 21 21 21 22 22 21 21 21 
21 22 21 21 21 21 21 21 21 21 21 21 21 21 21 21 21 21 21 21 21 21 21 21 21 21 21 21 21 21 21 21 21 21 21 21 21 21 21 21 21 21 21 21 22 22 21 21 21 21 
