21 22 21 21 21 21 21 22 21 21 22 21 21 21 21 22 21 21 21 21 21 21 21 21 21 21 21 21 21 21 21 21 21 21 21 21 22 21 21 21 21 21 21 21 21 22 22 21 21 22 
21 21 22 21 21 21 21 21 21 21 21 21 22 21 21 21 21 21 22 21 21 21 21 22 21 22 22 21 21 21 21 21 21 21 22 21 21 22 21 21 21 21 21 21 21 21 21 21 21 21 
21 21 21 21 21 21 22 21 22 21 21 21 21 21 22 21 21 21 21 22 21 21 22 21 21 21 21 21 22 21 21 22 21 21 21 21 21 21 21 22 21 21 22 21 21 21 21 21 21 21 
21 21 21 21 22 21 21 21 21 21 21 22 21 21 21 22 21 21 21 21 21 21 22 21 21 21 21 21 21 21 21 22 21 21 21 21 21 21 21 21 22 21 21 21 21 22 21 22 21 21 
22 21 21 21 31 29 29 29 29 29 29 29 32 21 22 21 21 31 29 29 29 29 29 29 29 29 32 21 21 21 21 21 21 21 22 21 21 22 21 21 21 21 21 22 21 21 21 21 21 21 
21 21 21 21 27 19 19 19 19 19 19 19 28 29 29 29 29 30 19 19 19 19 19 19 19 19 26 22 21 21 21 22 21 21 21 22 21 21 21 21 22 21 21 21 21 22 21 21 21 21 
21 21 22 21 27 19 12 10 10 10 13 19 19 19 19 19 19 19 19 12 10 10 10 10 13 19 28 32 21 22 21 21 31 29 29 29 29 29 29 29 29 29 32 21 21 21 21 21 22 21 
21 21 21 21 27 19 8 16 16 16 9 10 10 10 10 10 10 10 10 11 16 16 16 16 7 19 19 26 21 21 22 21 27 19 19 19 19 19 19 19 19 19 26 21 21 21 21 21 21 21 
21 21 21 21 27 19 8 16 0 16 3 3 3 3 3 3 3 3 3 16 16 16 16 16 7 17 19 26 22 21 21 21 27 19 12 10 10 10 10 10 13 19 26 21 22 21 21 21 21 21 
21 21 22 21 27 19 8 16 16 16 4 5 5 5 5 5 5 5 6 16 16 16 16 16 9 13 19 28 29 29 29 29 30 19 8 3 3 3 3 3 7 19 26 21 21 21 21 21 22 21 
21 21 21 21 27 19 14 5 5 5 15 19 19 19 19 19 19 19 8 16 16 16 16 16 16 7 19 19 19 19 19 19 19 19 8 3 3 3 3 3 7 19 26 21 21 22 21 21 21 22 
22 21 22 21 27 19 19 19 19 19 19 19 23 24 24 24 25 19 8 16 16 16 16 16 16 9 10 10 10 10 10 10 10 10 11 3 3 3 3 3 7 19 26 22 21 21 21 21 21 21 
21 21 21 21 33 24 24 24 24 24 24 24 34 22 21 21 27 19 14 6 16 16 16 16 16 16 16 3 3 3 3 3 16 16 3 3 3 16 3 3 7 19 26 21 21 21 21 22 21 21 
21 21 21 22 21 21 21 21 22 21 21 21 21 21 22 21 27 19 17 14 6 16 16 16 4 5 5 5 5 5 5 5 5 5 6 3 3 3 3 3 7 19 26 21 22 21 22 21 21 21 
22 21 21 21 31 29 29 29 29 29 29 29 29 29 29 32 27 19 19 19 8 16 16 16 7 19 19 19 19 19 19 19 19 19 8 3 3 3 3 3 7 19 26 21 21 21 21 21 21 21 
21 21 22 21 27 19 19 19 19 19 19 19 19 19 19 26 33 24 25 19 14 6 16 4 15 19 23 24 24 24 24 24 25 19 8 3 3 3 3 3 7 19 26 21 21 22 21 21 22 21 
21 21 21 21 27 19 12 10 10 10 13 19 19 19 19 26 21 21 27 19 19 8 16 7 19 19 26 21 22 21 21 22 27 19 14 5 5 5 5 5 15 19 26 21 21 21 22 21 21 21 
21 21 22 21 27 19 8 3 3 3 9 10 10 13 19 26 21 22 27 19 19 8 16 7 19 19 26 21 21 21 21 21 27 19 19 19 19 19 19 19 19 19 26 21 22 21 21 22 21 21 
21 21 21 21 27 19 8 3 0 3 16 16 16 7 19 26 22 21 27 19 19 8 16 7 19 19 26 21 21 22 21 21 33 24 24 24 24 24 24 24 24 24 34 21 21 22 21 21 21 21 
21 22 21 21 27 19 8 3 3 3 4 6 3 7 19 26 31 29 30 19 19 8 16 7 19 19 28 29 32 21 21 22 21 31 29 29 29 29 29 29 29 29 29 29 29 32 21 21 22 21 
21 21 21 22 27 19 14 5 5 5 15 8 3 7 19 26 27 19 19 19 19 8 16 7 19 19 19 19 26 21 21 21 21 27 19 19 19 19 19 19 19 19 19 19 19 26 21 21 21 21 
21 21 21 21 27 19 19 19 19 19 19 8 3 7 19 26 27 19 12 10 10 11 16 9 10 10 13 19 26 21 22 21 21 27 19 12 10 10 10 10 10 10 10 13 19 26 22 21 21 21 
21 22 21 21 27 19 19 19 19 19 19 8 3 7 19 26 27 19 8 16 16 16 16 16 16 16 7 19 26 21 21 21 21 27 19 8 0 16 3 3 3 3 3 7 19 26 21 21 22 21 
21 21 21 22 27 19 19 19 19 19 19 8 3 7 19 26 27 19 8 16 16 16 16 16 16 16 7 19 26 21 21 22 21 27 19 14 5 5 5 5 5 6 3 7 19 26 21 21 21 21 
21 21 21 21 27 19 19 19 19 19 19 8 3 7 19 26 27 19 8 16 16 16 3 16 16 16 7 19 26 31 29 29 29 30 19 19 19 19 19 19 19 8 3 7 19 26 22 21 21 21 
21 22 21 21 27 19 19 19 19 19 19 8 3 7 19 26 27 19 8 16 16 16 16 16 16 16 7 19 26 27 19 19 19 19 19 19 19 19 19 19 19 8 3 7 19 26 22 21 21 21 
22 21 21 21 27 19 12 10 10 10 13 8 3 7 19 26 27 19 8 16 16 16 16 16 16 16 7 19 26 27 19 12 10 10 10 10 10 13 19 19 19 8 3 7 19 26 21 21 21 21 
21 21 21 21 27 19 8 3 3 3 9 11 3 7 19 26 27 19 14 6 16 16 0 16 16 4 15 19 26 27 19 8 3 3 3 16 16 9 10 10 10 11 3 7 19 26 21 21 21 22 
21 21 21 21 27 19 8 3 0 3 3 3 3 7 19 26 27 19 17 14 5 5 5 5 5 15 17 19 26 27 19 8 3 16 3 16 3 3 3 3 3 3 16 7 19 26 21 22 21 21 
21 22 22 21 27 19 8 3 3 3 4 5 5 15 19 26 27 19 19 19 19 19 19 19 19 19 19 19 26 27 19 8 3 3 3 16 16 4 5 5 5 5 5 15 19 26 21 21 21 21 
21 21 21 21 27 19 14 5 5 5 15 19 19 19 19 26 33 24 24 24 24 24 24 24 24 24 24 24 34 27 19 14 5 5 5 5 5 15 19 19 19 19 19 19 19 26 21 21 21 21 
21 21 22 21 27 19 19 19 19 19 19 19 19 19 19 26 22 21 21 21 21 21 21 22 21 21 21 21 22 27 19 19 19 19 19 19 19 19 19 23 24 24 24 24 24 34 22 21 21 21 
21 21 21 21 33 24 24 24 24 24 24 24 24 24 24 34 21 21 21 22 21 22 21 21 21 21 21 21 21 33 24 24 24 24 24 24 24 24 24 34 21 21 21 21 21 21 21 21 22 21 
21 22 21 21 31 29 29 29 29 29 29 29 29 29 29 29 32 22 21 21 21 22 21 21 22 21 21 22 21 31 29 29 29 29 29 29 29 29 29 32 21 21 21 22 21 21 21 21 21 22 
21 21 21 21 27 19 19 19 19 19 19 19 19 19 19 19 26 21 21 22 21 21 21 21 21 21 21 22 21 27 19 19 19 19 19 19 19 19 19 26 21 22 21 21 21 22 21 21 21 21 
21 21 21 21 27 19 19 17 19 17 19 17 19 17 19 19 28 29 29 29 29 29 29 29 29 29 29 29 29 30 19 19 19 19 19 19 19 19 19 26 21 21 21 21 21 21 21 21 21 21 
21 21 21 22 27 19 19 19 23 24 24 24 24 24 25 19 19 19 19 19 19 19 19 19 19 19 19 19 19 19 19 17 19 17 19 17 19 19 19 26 21 21 21 22 22 21 21 21 21 22 
21 22 21 21 27 19 19 17 26 31 29 29 29 32 27 19 19 12 10 10 10 10 10 10 10 10 10 10 10 13 19 12 10 10 10 13 17 19 19 26 21 22 21 21 21 22 21 22 21 21 
21 21 21 21 27 19 19 19 26 27 19 17 19 28 30 12 10 11 3 3 3 3 3 3 3 3 3 3 3 9 19 11 3 3 3 7 19 19 19 26 21 21 21 21 21 21 21 21 21 21 
22 21 21 21 27 19 19 17 26 27 17 0 17 17 17 8 3 3 3 3 16 16 16 16 16 16 3 3 3 3 16 3 3 16 3 7 17 19 19 26 21 22 21 21 21 21 21 21 21 21 
21 21 22 21 27 19 19 19 26 27 19 17 19 23 25 14 5 6 16 16 3 3 3 3 3 3 3 3 3 4 19 6 3 3 3 7 19 19 19 26 21 21 21 22 21 21 21 21 21 21 
21 21 21 21 27 19 19 17 26 33 24 24 24 34 27 19 19 14 5 5 5 5 5 5 5 5 5 5 5 15 19 14 5 5 5 15 17 19 19 26 21 21 21 21 21 21 21 21 22 21 
21 22 21 21 27 19 19 19 28 29 29 29 29 29 30 19 19 19 19 19 19 19 19 19 19 19 19 19 19 19 19 17 19 17 19 17 19 19 19 26 22 21 21 21 21 22 21 21 21 21 
21 21 21 21 27 19 19 17 19 17 19 17 19 17 19 19 23 24 24 24 24 24 24 24 24 24 24 24 24 25 19 19 19 19 19 19 19 19 19 26 21 21 21 22 21 21 21 21 21 21 
21 21 21 21 27 19 19 19 19 19 19 19 19 19 19 19 26 21 22 21 21 21 21 21 21 21 21 22 21 27 19 19 19 19 19 19 19 19 19 26 21 22 21 21 21 21 21 21 21 21 
21 21 21 22 33 24 24 24 24 24 24 24 24 24 24 24 34 21 21 21 21 22 21 21 22 21 21 21 21 33 24 24 24 24 24 24 24 24 24 34 21 21 21 21 22 21 22 21 21 21 
21 21 22 21 21 21 21 21 21 21 21 21 21 21 21 21 22 21 21 21 21 21 21 21 21 21 22 21 21 21 21 22 21 21 21 21 21 21 21 22 21 21 21 21 21 21 21 21 21 22 
22 21 21 21 21 21 21 21 21 21 22 21 21 21 21 21 21 22 21 21 21 21 21 21 21 21 21 21 21 21 21 21 21 21 22 22 21 21 21 21 21 21 22 22 21 21 22 21 21 21 
21 21 21 21 21 21 22 21 21 21 21 21 21 21 21 21 21 21 21 21 22 21 21 22 21 21 22 21 22 21 21 21 21 21 21 21 22 21 21 21 21 21 21 21 21 21 21 21 21 21 
21 21 21 21 22 21 21 21 21 21 22 21 21 21 21 21 21 21 21 21 21 21 21 21 21 21 21 21 21 21 22 21 21 21 21 21 21 21 21 21 22 21 21 21 22 21 21 21 21 22 
